

NO ./maps/textures/purplestone.png
SO ./maps/textures/mossy.png
WE ./maps/textures/wood.png
EA ./maps/textures/redbrick.png

F 100,100,100

C 255,0,0

1111111111111111111
1000000010000000001
1000000000000000001
1000000010000000001
1110111111110111111
1000000010000000000111111111111111111
100000000000S000000000000000000000001
1000000010000000000000000010000000001
1000000010000000000000000010000000001
1000000010000000000000000010000000001
1000000010000000000000000010000000001
1111111111111111111111111111111111111